LIGNEl 099999999999999999999999
LIGNEk 090000000200000000030009
LIGNEj 090099000000000000000009
LIGNEi 090000009999900000000009
LIGNEh 090000007006000000000009
LIGNEg 090000000000009999000009
LIGNEf 090000000000000070000009
LIGNEe 090999999000000000999909
LIGNEd 098000400800000000000609
LIGNEc 090000000009999900000009
LIGNEb 090000000080400080000009
LIGNEa 090000000000000000000009
