LIGNEl 099999999999999999999999
LIGNEk 090000000000040000070009
LIGNEj 090000000000000000009909
LIGNEi 090000000999999999000009
LIGNEh 090990008000307000800009
LIGNEg 090600999900000000000009
LIGNEf 090008030080000000000009
LIGNEe 090000000000009990000009
LIGNEd 090000000000000200000009
LIGNEc 090000000000000009990009
LIGNEb 090000000000000000600009
LIGNEa 090000000000000000000009
