LIGNEl 090000099999999999999999
LIGNEk 090000900030000000000089
LIGNEj 090009000000000000000909
LIGNEi 090096000000009999900709
LIGNEh 090900009999909300900009
LIGNEg 099000009969909000000909
LIGNEf 099999909000909900000909
LIGNEe 093000089000900700000909
LIGNEd 090000000000000000000909
LIGNEc 020009000000000000000009
LIGNEb 000009000000000000000009
LIGNEa 099999000000000000000009
