LIGNEl 099999999999999999999999
LIGNEk 090000040000000000000009
LIGNEj 090990000000000000000009
LIGNEi 090920000099909900000009
LIGNEh 090900099009006900999909
LIGNEg 090000990006000008400089
LIGNEf 090008308000090000000009
LIGNEe 090000000999099000009009
LIGNEd 090000008030879000099009
LIGNEc 090099000000000009079009
LIGNEb 090096000000000999000009
LIGNEa 090000000000008400800009
