LIGNEl 099999999999999999999999
LIGNEk 090009000003000000070009
LIGNEj 090090000000009999900009
LIGNEi 090920000000099000990009
LIGNEh 099000099900996000799009
LIGNEg 090000803080000000009909
LIGNEf 090090000000000090009909
LIGNEe 090960000000000060009909
LIGNEd 090000900000990000099009
LIGNEc 090000090000099000996009
LIGNEb 090000069000009999900009
LIGNEa 090000000900084000080009
