LIGNEl 099999999999999999999999
LIGNEk 090000000000000000040009
LIGNEj 090990000000000000000009
LIGNEi 090200009999900000000009
LIGNEh 090000080004080000000009
LIGNEg 090000000000009999000009
LIGNEf 090000000000087030800009
LIGNEe 090999999000000000999909
LIGNEd 098060300800000008040789
LIGNEc 090000000009999900000009
LIGNEb 090000000080400080000009
LIGNEa 090000000000000000000009
