LIGNEl 090000099999999999999999
LIGNEk 090000900040000030000089
LIGNEj 090009000000009999900909
LIGNEi 090097000000009003900709
LIGNEh 090900009999909000000009
LIGNEg 099000009969909900000909
LIGNEf 099999909000900000000909
LIGNEe 094000089000900000000909
LIGNEd 090000000000000000000009
LIGNEc 020009000000000000000009
LIGNEb 000009000000000000000009
LIGNEa 099999000000000000000009
