LIGNEl 099999999999999999999999
LIGNEk 090070000000040000000009
LIGNEj 090000000000000000000009
LIGNEi 090000000999999999000009
LIGNEh 090990008000400700800009
LIGNEg 090600000000000000000009
LIGNEf 090000999990000000000009
LIGNEe 090008040708009990000009
LIGNEd 090000000000000200000009
LIGNEc 090000000000000009990009
LIGNEb 090000000000000000700009
LIGNEa 090000000000000000000009